2
9
*********
*  R*  S*
* **    *
*     * *
* * * ***
*F       
* * **** 
*   *E   
**    ***
10
**********
*S   *  R*
* ** * * *
* *  * * *
* * **   *
* *    * *
* **** * *
*    E   *
*   *   F*
**********